1111111111111
1001000000001
1N00011111C01
1P0011E000001
1111111111111